################################################################################
################################################################################
######......#########################....................................#######
######...................................................................#######
######......##################.######....................................#######
######......##################.######....................................#######
#######.###.######.......................................................#######
#######.###.######.......................................................#######
#######.###.######..............#####....................................#######
#######.###.#######..################....................................#######
#######.###.#######..#########################...######.###########...##########
#######.###.#######..#########################...######.###########...##########
#######.###.#######..#########################...######.###########...##########
#######.##.......................#############...######.###########...##########
#######.##.......................#############...#####......#######...##########
#######.##.......................#############...#####......#######...##########
#######.##.......................#############...#####......#######...##########
#######.##..................................................#######...##########
#######.##.....@...........................................•#######...##########
#######.##.......................#############...#####...•........•...•......###
#######.##.......................#############...###############.....•.......###
#######.##.......................#############...###############•......••....###
#######.##.......................#############...###..........##.....•.......###
#######.##.......................#############...###..........##•............###
#######.##.......................#############...###..........##.............###
#######.##.......................#############...###..........##.............###
#######.##.......................#############...###..........##.............###
#######.##.......................#######..........##.........................###
#######.##.......................#######..........##.........................###
#######.#######.#############..#########..........##.........................###
#######.#######.#############..#########..........##..........##.............###
#######.#######.#############..#########..........##..........##.............###
####............####................####..........##############.............###
####............####................####..........##############.............###
####................................####..........##############.............###
#####..#############..............................##############.............###
#####..#############..............................##############.............###
#####..#############................############################.............###
#.......############................############################.............###
#.......############................############################.............###
#.......############................############################.............###
#............................................................................###
#............................................................................###
#............................................................................###
#.......############................############################.............###
####################................############################################
####################................############################################
####################................############################################
################################################################################
################################################################################